*****************************
@EFWA     R           *     *
*****B  *R*  * ** *** * ***R*
*       *B*B * B*B*BR * *B*B*
*B  B # **** ********** * ***
*        *B***     R*B* *   *
* B  *R*** *    ***B* *   * *
*    * B*  *R** *B*** ***** *
*    *  R   B*              *
*****************************